...............
...............
...............
...............
...............
...............
...............
........#......
1      ##     X
###############